#######################################
# Datatypes (KEYWORD1)
#######################################

BHYSensor	KEYWORD1
bhyVirtualSensor	KEYWORD1
bhyQuaternion	KEYWORD1
bhyVector	KEYWORD1
bhyVectorUncalib	KEYWORD1
bhyActivityEvent	KEYWORD1
bhyMetaEvent	KEYWORD1
bhyBSX	KEYWORD1
bhySensorConfiguration	KEYWORD1
bhyPhysicalStatus	KEYWORD1
bhySensorInformation	KEYWORD1
bhySensorStatus	KEYWORD1
bhyHostStatus	KEYWORD1
bhyInterruptStatus	KEYWORD1
bhyChipStatus	KEYWORD1
bhyHostInterfaceControl	KEYWORD1
bhySoftPassThrough	KEYWORD1
bhySensorStatusBank	KEYWORD1
bhyTimestamp	KEYWORD1

#######################################
# Methods and Functions (KEYWORD2)
#######################################

begin	KEYWORD2
getErrorString	KEYWORD2
read	KEYWORD2
write	KEYWORD2
readByte	KEYWORD2
readShort	KEYWORD2
readInteger	KEYWORD2
writeByte	KEYWORD2
writeShort	KEYWORD2
writeInteger	KEYWORD2
loadFirmware	KEYWORD2
run	KEYWORD2
configVirtualSensor	KEYWORD2
disableVirtualSensor	KEYWORD2
getSensorName	KEYWORD2
getMetaEventName	KEYWORD2
getConfiguration	KEYWORD2
getSensorInformation	KEYWORD2
getSensorStatus	KEYWORD2
installSensorCallback	KEYWORD2
uninstallSensorCallback	KEYWORD2
installTimeCallback	KEYWORD2
uninstallTimeCallback	KEYWORD2
isMetaEventEnabled	KEYWORD2
isMetaInterruptEnabled	KEYWORD2
enableMetaEvent	KEYWORD2
enableMetaEventInterrupt	KEYWORD2
getLastTimestamp	KEYWORD2
getLastIrqTimestamp	KEYWORD2
getCurrentTime	KEYWORD2
getRamVersion	KEYWORD2
getProductId	KEYWORD2
getRevisionId	KEYWORD2
getRomVersion	KEYWORD2
getFifoWatermark	KEYWORD2
setFifoWatermark	KEYWORD2
getFifoSize	KEYWORD2
setFifoFlush	KEYWORD2
getFifoFlush	KEYWORD2
getChipControl	KEYWORD2
setChipControl	KEYWORD2
setResetRequest	KEYWORD2
setHostInterfaceControlBit	KEYWORD2
getHostInterfaceControl	KEYWORD2
getHostStatus	KEYWORD2
getInterruptStatus	KEYWORD2
getChipStatus	KEYWORD2
getPhysicalSensorStatus	KEYWORD2

#######################################
# Instances(KEYWORD2)
#######################################

#######################################
# Class members(KEYWORD2)
#######################################

deviceId	KEYWORD2
productId	KEYWORD2
status	KEYWORD2

#######################################
# Constants(LITERAL1)
#######################################

# Error Code Definitions
BHY_OK	LITERLAL1
BHY_E_NULL_PTR	LITERLAL1
BHY_E_COM_FAIL	LITERLAL1
BHY_E_DEV_NOT_FOUND	LITERLAL1
BHY_E_OUT_OF_RANGE	LITERLAL1
BHY_E_INVALID_INPUT	LITERLAL1
BHY_E_ACCEL_ODR_BW_INVALID	LITERLAL1
BHY_E_GYRO_ODR_BW_INVALID	LITERLAL1
BHY_E_LWP_PRE_FLTR_INT_INVALID	LITERLAL1
BHY_E_LWP_PRE_FLTR_INVALID	LITERLAL1
BHY_E_AUX_NOT_FOUND	LITERLAL1
BHY_FOC_FAILURE	LITERLAL1

BHY_E_INVALID_FIRMWARE	LITERLAL1
BHY_E_RAMPATCH_MISMATCH	LITERLAL1
BHY_E_CRC_MISMATCH	LITERLAL1

BHY_E_PRODUCT_ID_MISMATCH	LITERLAL1
BHY_E_UNKNOWN_ERROR	LITERLAL1

# I2C Addresses
BHY_I2C_ADDR	LITERLAL1
BHY_I2C_ADDR2	LITERLAL1

# Virtual sensor IDs
BHY_VS_ACCELEROMETER	LITERLAL1
BHY_VS_GEOMAGNETIC_FIELD	LITERLAL1
BHY_VS_ORIENTATION	LITERLAL1
BHY_VS_GYROSCOPE	LITERLAL1
BHY_VS_LIGHT	LITERLAL1
BHY_VS_PRESSURE	LITERLAL1
BHY_VS_TEMPERATURE	LITERLAL1
BHY_VS_PROXIMITY	LITERLAL1
BHY_VS_GRAVITY	LITERLAL1
BHY_VS_LINEAR_ACCELERATION	LITERLAL1
BHY_VS_ROTATION_VECTOR	LITERLAL1
BHY_VS_RELATIVE_HUMIDITY	LITERLAL1
BHY_VS_AMBIENT_TEMPERATURE	LITERLAL1
BHY_VS_MAGNETIC_FIELD_UNCALIBRATED	LITERLAL1
BHY_VS_GAME_ROTATION_VECTOR	LITERLAL1
BHY_VS_GYROSCOPE_UNCALIBRATED	LITERLAL1
BHY_VS_SIGNIFICANT_MOTION	LITERLAL1
BHY_VS_STEP_DETECTOR	LITERLAL1
BHY_VS_STEP_COUNTER	LITERLAL1
BHY_VS_GEOMAGNETIC_ROTATION_VECTOR	LITERLAL1
BHY_VS_HEART_RATE	LITERLAL1
BHY_VS_TILT	LITERLAL1
BHY_VS_WAKE_GESTURE	LITERLAL1
BHY_VS_GLANCE_GESTURE	LITERLAL1
BHY_VS_PICKUP_GESTURE	LITERLAL1
BHY_VS_ACTIVITY_RECOGNITION	LITERLAL1

# FIFO flush options
BHY_FLUSH_NONE	LITERLAL1
BHY_FLUSH_ONE	LITERLAL1
BHY_FLUSH_ALL	LITERLAL1


